__2 __4 __2 __2 __4 __4 __0 __0 __4 __0
__4 __2 __4 __4 __4 __4 __4 __4 __0 __4
__4 __2 __4 __4 __4 __4 __4 __4 __0 __4
__4 __4 __4 __4 __4 __4 __4 __4 __4 __4
__4 __4 __4 __4 __4 __4 __4 __4 __4 __4
__4 __4 __4 __4 __4 __4 __4 __4 __4 __4
__4 __4 __4 __4 __4 __4 __4 __4 __4 __4
__4 __3 __4 __4 __4 __4 __4 __4 __1 __4
__4 __3 __4 __4 __4 __4 __4 __4 __1 __4
__3 __4 __3 __3 __4 __4 __1 __1 __4 __1
r12332101123221231011023012021033010123
