__0 __0 __0 __0 __0 __0 __0 __0 __0 __0
__0 __0 __0 __0 __0 __0 __0 __0 __0 __0
__0 __0 __0 __0 __0 __0 __0 __0 __0 __0
__0 __0 __0 __0 __0 __0 __0 __1 __0 __0
__0 __0 __0 __0 __0 __0 __0 __1 __0 __0
__0 __0 __0 __0 __0 __0 __0 __0 __1 __0
__0 __0 __0 __0 __0 __0 __0 __1 __0 __0
__0 __0 __0 __0 __0 __0 __0 __1 __0 __0
__0 __0 __0 __0 __0 __0 __0 __0 __0 __0
__0 __0 __0 __0 __0 __0 __0 __0 __0 __0
r12332101123221231011023012021033010123
